Size
24 rows
24 columns

Walls
row 1
2 7 11 13 15 18
row 2
4 6 8 9 10 12 14 15 16 18 20 22
row 3
1 6 7 8 10 11 14 16 17 19 21 22 23
row 4
2 4 7 10 12 13 14 15 17 18 19 22 23
row 5
1 2 5 9 11 12 14 15 18 21 23
row 6
1 4 6 7 8 10 11 12 13 17 18 20 21
row 7
2 4 5 6 7 12 14 15 17 18 19 20
row 8
2 3 5 6 7 9 11 15 16 18 19 20 22
row 9
2 3 6 8 12 14 16 17 19 22 23
row 10
1 3 4 5 6 11 13 14 18 20 21 23
row 11
1 4 8 9 12 16 18 20 21
row 12
1 2 7 9 10 12 13 15 17 23
row 13
2 3 4 7 8 10 11 13 14 16 19 20
row 14
3 4 5 8 9 11 15 17 20 21
row 15
4 5 8 9 10 11 13 15 16 19 20 23
row 16
3 5 9 10 12 14 15 19 21 22 23
row 17
3 4 5 8 13 14 16 19 21 22
row 18
2 3 7 9 13 15 20
row 19
2 3 4 10 12 14 16 20 21 23
row 20
3 7 9 11 12 14 19 21 22
row 21
3 8 11 13 15 16 18 20
row 22
3 6 7 10 12 15 17 18 19
row 23
2 4 5 6 9 10 11 12 14 17 19 22
row 24
4 9 11 16 20
column 1
3 7 12 18 21 23
column 2
1 2 4 6 8 10 13 14 16 18 19 20 21 22
column 3
2 3 6 10 14 15 20 22 23
column 4
2 3 4 5 6 8 11 12 15 18 21
column 5
2 3 5 8 9 11 12 17 19 20 21 22
column 6
1 3 5 11 12 13 15 17 18 19 20 21
column 7
2 4 8 10 11 13 14 15 16 17 18 19 20 23
column 8
1 4 7 9 10 14 15 16 18 20 22
column 9
3 4 6 7 9 10 12 16 18 19 21 22
column 10
2 5 6 8 9 10 13 16 17 18 20 21
column 11
1 4 7 8 9 11 16 17 18 20 22
column 12
2 4 7 9 12 14 16 17 21
column 13
2 3 7 8 10 13 15 17 18 20 21 23
column 14
2 5 7 8 10 12 14 16 19 21 22
column 15
3 8 10 11 13 14 17 19 20 22 23
column 16
3 5 6 9 10 12 15 17 19 22
column 17
1 4 5 6 9 10 11 13 15 16 18 19 20 21 23
column 18
2 4 8 10 12 13 14 15 16 17 18 19 20
column 19
1 5 9 11 12 14 16 17 18 20 23
column 20
1 3 4 5 7 10 13 16 18 20 22
column 21
1 3 4 8 9 12 15 17 19 21 22 23
column 22
1 5 6 7 9 11 12 16 14 17 20 21 22
column 23
4 6 7 10 11 12 13 14 17 18 20 21 22 23
column 24
1 6 10 16 19 22

Traps
5 5
3 3 
12 5
3 6
21 5
22 22
7 7
8 8
9 9
20 5
7 19
13 10
2 21
6 17
3 22
6 10
11 12
13 13

Start
1 1

Goals
17 19

